4,4,4,4,4,4,4,4,4,4,4,4,4,4,4,4,4,4,4,4,4,4,4,4,4,4,4,4,4,4
4,4,4,4,4,4,4,4,4,4,4,4,1,4,4,4,4,4,4,4,4,4,1,1,1,4,4,4,4,4
4,4,4,4,4,4,4,4,4,4,1,1,1,1,1,1,1,1,1,1,1,1,1,1,1,1,1,1,4,4
4,4,4,4,4,4,4,4,4,1,2,2,2,2,2,2,2,2,2,1,1,1,1,1,1,1,1,1,4,4
4,4,4,4,4,4,4,1,1,2,2,3,3,3,3,3,3,3,2,2,2,2,1,1,1,1,1,1,4,4
4,4,4,4,4,4,4,1,1,2,2,3,3,3,3,3,3,3,3,3,3,2,2,1,1,1,1,1,4,4
4,4,4,4,4,4,1,1,1,2,3,3,3,3,3,3,3,3,3,3,3,3,2,2,2,1,1,4,4,4
4,4,4,4,4,4,1,1,1,2,3,3,3,3,3,3,3,3,3,3,3,3,3,3,2,1,4,4,4,4
4,4,4,4,4,1,1,1,2,2,3,3,3,3,3,3,3,3,3,3,3,3,3,3,2,1,4,4,4,4
4,4,4,4,4,1,1,1,2,2,3,3,3,3,3,3,3,3,3,3,3,3,3,3,2,1,1,4,4,4
4,4,4,4,1,1,1,1,1,2,3,3,3,3,3,3,3,3,3,3,3,3,3,2,2,1,1,4,5,4
4,4,4,4,4,1,1,1,2,2,3,3,3,3,3,3,3,3,3,3,3,3,2,2,1,1,5,5,5,4
4,4,4,4,4,4,1,1,2,2,3,3,3,3,3,3,3,3,3,3,3,3,2,1,1,1,5,5,5,4
4,4,4,4,4,4,1,1,2,2,3,3,3,3,3,3,3,3,3,3,3,3,2,2,1,1,5,5,5,4
4,4,4,4,4,1,1,1,1,2,3,3,3,3,3,3,3,3,3,3,3,3,2,2,1,1,5,5,5,4
4,4,4,4,1,1,1,1,1,2,3,3,3,3,3,3,3,3,3,3,3,3,2,2,1,1,5,5,5,4
4,4,4,4,1,1,1,2,2,2,3,3,3,3,3,3,3,3,3,3,3,3,2,1,1,1,1,5,5,5
4,5,5,4,1,1,1,1,1,2,3,3,3,3,3,3,3,3,3,3,2,2,2,2,1,1,1,5,5,5
4,5,5,4,1,1,1,1,1,2,3,3,3,3,3,2,2,3,3,2,2,2,2,2,2,1,1,5,5,5
5,5,5,4,1,1,1,1,1,2,3,2,3,3,2,2,2,2,2,2,2,2,2,2,2,1,5,5,5,5
5,5,5,4,1,1,1,2,2,2,2,2,2,2,2,2,2,2,2,2,2,2,2,2,2,1,5,5,5,5
5,5,5,4,1,1,1,2,2,2,2,2,2,2,2,1,1,2,2,2,2,2,2,2,2,1,5,5,5,5
5,5,4,4,4,1,1,1,2,2,1,1,1,1,1,1,1,1,1,2,2,2,2,2,1,1,5,5,5,5
5,5,4,4,4,1,1,1,1,1,1,1,1,1,1,1,1,1,2,2,2,2,2,2,1,1,5,5,5,5
5,5,1,1,1,1,1,1,1,1,1,1,1,1,1,1,1,1,2,2,1,1,2,2,1,1,5,5,5,5
5,5,1,1,1,1,1,1,1,1,1,1,1,1,1,1,1,1,1,1,1,1,1,1,1,1,5,5,5,5
5,5,5,5,5,5,5,1,1,5,5,5,5,5,1,1,5,5,5,1,1,1,1,1,5,5,5,5,5,5
5,5,5,5,5,5,5,5,5,5,5,5,5,5,5,5,5,5,5,5,5,5,5,5,5,5,5,5,5,5
5,5,5,5,5,5,5,5,5,5,5,5,5,5,5,5,5,5,5,5,5,5,5,5,5,5,5,5,5,5
5,5,5,5,5,5,5,5,5,5,5,5,5,5,5,5,5,5,5,5,5,5,5,5,5,5,5,5,5,5
